index,wave,zombie,explsionZombie,ghoul,raptor,pachy,boss,totalEnemy
0,1,5,0,0,0,0,0,5
1,2,5,2,0,2,0,0,9
2,3,7,3,0,2,0,0,12
3,4,7,5,0,3,1,0,16
4,5,5,5,1,5,1,1,18
5,6,9,7,1,3,3,0,23
6,7,9,7,3,5,3,0,27
7,8,9,9,5,5,5,0,33
8,9,11,10,7,5,5,0,38
9,10,13,10,7,5,5,1,41
