index,wave,zombie,rangeZombie,explsionZombie,ghoul,raptor,pachy,boss,totalEnemy
0,1,5,0,0,0,0,0,0,5
1,2,5,3,2,0,0,0,0,10
2,3,5,3,3,1,2,2,0,16
3,4,5,3,5,2,3,3,0,21
4,5,5,5,5,3,3,3,1,25
5,6,7,5,5,3,5,5,0,30
6,7,7,5,7,5,5,5,0,34
7,8,7,7,7,5,5,5,0,36
8,9,10,7,7,5,5,7,0,41
9,10,10,9,10,5,5,7,1,47
